11111111111111
1001010C000001
10000101100111
1P0011001E0001
100001C1100011
10011100000011
10000000C000C1
11111110111111
