1111111111111111111
100100C0000000000C1
1000001100111100001
1P001001E000010C001
10000C1100010101001
1001100000010111001
1000000C000C0100011
1111111111111111111
